##########
#S#     ##
# # ### ##
#   #    #
### # ####
#   #    #
# ### #  #
#     # F#
##########
